8 8
########
###$####
###*####
###@*@$#
#$*@+###
####@###
####$###
########
