9 9 3
#########
##***####
##***#**#
###*+@*$#
###*###$#
#*@*###$#
#*@*#####
#***#####
#########
