6 8 1
########
#***####
#*#*####
#****@+#
###$####
########
