8 10 4
##########
#$****@*+#
#*@*#****#
#**$####*#
#***#**#*#
#*@*#*@#*#
#$******$#
##########
