6 6
######
#+**##
#$$@*#
#*@#*#
#****#
######
